GFilter	KEYWORD1
GHFilter	KEYWORD1
GHKFilter	KEYWORD1
GFState	KEYWORD1
update	KEYWORD2
setState	KEYWORD2
getState	KEYWORD2
getError	KEYWORD2
setProcessDEV	KEYWORD2
setProcessVAR	KEYWORD2
getProcessDEV	KEYWORD2
getProcessVAR	KEYWORD2
setMeasurementDEV	KEYWORD2
setMeasurementVAR	KEYWORD2
getMeasurementDEV	KEYWORD2
getMeasurementVAR	KEYWORD2
setPeriod	KEYWORD2
getPeriod	KEYWORD2
getCoef	KEYWORD2
GFDisplacement	LITERAL1
GFVelocity	LITERAL1
GFAcceleration	LITERAL1